
M	C	C	M	M	C	T	R	U	O	U	U	U	R	E	P	U	C	C	T	C	T	P	C	C	C
C	U	U	P	C	M	M	P	R	T	C	C	R	U	P	E	C	C	M	U	U	P	C	M	P	E
P	P	U	P	U	R	U	P	P	M	E	U	P	U	C	E	U	U	C	U	C	C	C	M	E	M
T	U	P	E	T	P	C	M	R	C	M	C	C	U	C	C	M	P	E	C	R	T	M	R	U	P
M	P	M	R	C	P	M	M	C	R	U	M	C	U	U	E	U	R	P	P	C	M	O	U	U	E
U	C	C	M	U	M	T	U	C	U	C	U	T	M	U	U	U	P	M	U	U	C	T	C	U	P
M	M	C	C	R	P	P	P	P	M	M	M	M	E	E	U	M	R	C	C	C	P	U	U	E	U
P	M	U	M	M	C	C	P	E	C	U	C	U	P	C	T	C	U	E	P	M	P	C	U	U	E
E	U	U	U	T	P	M	M	U	C	C	T	C	C	P	P	P	C	T	P	U	C	U	C	C	C
U	R	E	U	T	U	C	M	E	P	C	C	E	M	U	U	U	P	R	M	M	T	M	U	C	M
M	M	C	C	C	C	C	C	M	E	P	U	E	C	U	M	R	E	R	U	U	U	U	M	U	R
C	C	P	M	U	U	R	U	U	P	M	U	P	R	P	P	U	U	U	U	M	R	C	C	P	C
P	E	U	R	M	M	M	P	U	T	C	R	U	U	E	O	U	U	U	M	C	M	U	U	R	U
P	U	R	U	C	M	U	C	R	U	M	M	C	U	P	U	U	M	U	C	R	E	U	U	U	P
C	C	U	R	R	C	P	R	M	C	T	R	C	U	U	U	R	C	T	P	P	M	U	U	C	C
U	U	U	U	M	U	U	E	P	C	R	M	E	P	M	P	U	U	C	C	C	U	M	M	U	U
M	C	U	C	M	C	C	C	R	T	C	C	M	E	E	U	P	T	M	U	U	M	M	M	C	C
P	P	T	M	C	P	T	E	O	U	U	U	M	U	U	C	R	M	C	C	C	M	C	P	R	C
R	C	E	P	M	C	M	C	P	U	U	C	M	C	C	O	M	T	P	R	C	M	C	P	C	P
M	C	P	C	E	R	R	E	C	C	R	R	E	C	R	U	P	U	E	E	P	M	U	M	T	C
U	C	E	U	U	T	P	C	E	U	M	R	C	U	U	U	R	R	U	C	R	U	U	C	R	P
P	T	T	C	P	C	P	C	U	C	U	M	U	M	P	E	C	E	E	R	P	M	R	M	M	U
R	U	M	E	P	M	R	M	M	C	P	R	U	C	R	C	P	E	E	R	P	U	U	U	U	R
E	P	C	C	M	M	E	P	P	P	R	C	C	U	M	P	C	C	C	M	M	E	E	U	U	P
P	E	R	U	E	C	P	U	E	M	U	C	C	U	U	C	P	U	E	P	U	C	M	C	M	C
U	U	C	M	M	M	C	U	P	C	C	M	M	U	U	U	C	U	O	P	U	C	U	P	M	P
U	E	C	C	E	U	P	M	C	E	P	R	C	T	R	M	C	C	U	U	T	E	C	E	C	C
R	M	U	C	U	R	U	C	M	U	C	R	C	M	P	C	C	U	O	R	U	C	T	U	C	C
M	C	U	C	M	U	M	M	T	R	U	M	C	M	M	C	P	U	U	M	U	P	C	C	M	P
C	U	U	E	P	C	T	E	C	T	U	U	T	C	E	E	M	T	U	C	T	E	P	P	R	U
U	M	U	U	E	C	M	U	M	R	U	E	P	C	U	M	P	P	O	U	R	U	C	C	U	P
U	C	U	C	U	E	P	C	M	M	E	C	C	U	C	E	C	P	P	C	C	C	C	O	C	R
C	R	C	R	T	U	C	P	P	T	P	U	O	C	U	O	R	U	C	C	C	E	U	C	P	P
M	R	R	C	E	U	U	U	R	U	R	C	C	M	T	P	P	U	R	P	P	C	T	R	R	T
R	U	U	P	M	T	M	U	U	E	T	R	P	R	O	E	M	P	T	P	T	E	P	R	E	R
P	T	R	U	U	U	M	T	R	U	M	T	P	P	P	R	U	U	P	E	O	U	T	P	T	R
O	M	U	U	E	R	M	M	E	P	U	T	T	O	T	O	O	M	T	P	R	M	P	P	T	M
R	E	U	R	R	U	P	M	T	R	P	P	R	E	M	U	P	R	T	R	M	M	E	O	U	M
M	U	P	U	U	O	U	M	E	M	O	M	E	C	P	E	U	U	U	U	C	R	U	T	T	T
R	T	U	P	T	T	P	E	R	E	M	U	U	R	E	E	P	E	T	R	M	P	T	R	U	U
U	O	T	R	U	U	O	O	T	T	T	O	T	T	E	T	E	T	O	U	P	O	M	T	U	U
O	U	T	O	E	E	T	P	T	E	M	U	U	T	U	R	C	U	O	P	T	R	P	O	T	E
E	M	C	O	U	U	E	P	R	M	P	T	T	T	U	P	P	R	E	T	T	R	O	E	M	U
E	T	P	O	P	M	T	E	R	T	E	U	U	U	P	U	P	U	U	E	M	M	O	T	O	U
M	O	R	R	C	M	U	U	U	E	T	U	O	T	T	E	M	T	T	C	T	M	E	T	E	R
E	U	M	U	E	E	T	U	M	E	T	P	U	T	P	U	E	T	T	M	P	E	E	R	T	C
P	T	O	U	U	T	R	E	R	E	T	U	T	R	E	T	R	T	R	U	T	C	M	T	C	U
U	T	P	O	M	T	T	P	T	P	T	O	U	M	E	O	T	T	R	P	E	P	U	T	T	T
R	T	T	O	U	M	U	U	T	P	E	E	C	T	M	P	P	M	U	E	C	T	R	P	U	C
T	E	U	U	E	T	P	T	O	T	P	M	T	M	C	P	U	E	P	P	U	P	R	M	T	P
C	R	U	R	P	R	E	M	E	R	T	U	E	E	R	O	R	O	T	O	M	M	R	C	U	U
E	U	T	P	T	E	P	P	E	U	U	T	P	O	T	P	P	M	E	P	E	M	T	R	E	E
U	T	U	U	T	O	T	P	R	E	E	R	O	P	O	R	R	M	U	U	T	M	P	R	T	T
M	E	E	E	T	E	R	U	T	M	T	O	O	C	P	E	P	P	M	P	M	T	P	R	R	M
E	P	R	E	U	M	M	P	R	T	R	E	E	P	U	T	T	P	E	C	T	U	R	U	R	C
O	P	E	E	E	O	O	U	E	M	O	M	P	T	U	E	C	E	R	M	M	M	P	P	E	P
M	U	E	M	U	R	T	E	U	M	R	T	T	P	U	T	C	E	R	O	E	T	M	U	U	R
O	T	U	T	T	R	M	U	E	T	E	T	T	R	P	R	O	U	T	U	U	P	R	E	U	T
T	R	T	P	M	T	U	P	E	E	M	E	T	E	P	T	O	E	T	U	U	T	E	P	T	M
U	U	E	E	P	P	T	P	M	U	P	T	E	P	R	M	U	T	T	P	M	U	M	M	E	C
R	E	T	E	P	T	R	T	U	R	P	M	T	O	O	U	E	E	O	T	O	U	R	U	U	R
T	U	E	U	T	P	O	M	T	P	P	U	R	E	O	T	C	M	C	P	R	P	R	O	O	E
E	R	U	U	E	E	R	U	M	U	U	U	C	P	P	C	P	U	E	T	E	R	U	R	P	O
R	P	T	P	C	T	P	E	R	E	R	M	U	T	T	R	E	U	P	R	T	M	E	C	U	R
E	P	P	O	U	T	M	O	T	C	T	M	P	T	P	O	E	U	U	T	O	T	P	T	O	R
E	U	E	T	U	R	M	E	T	R	E	P	E	E	P	R	U	C	P	E	M	M	P	T	M	U
U	T	T	E	O	E	R	M	U	R	U	U	R	U	T	P	T	T	E	C	E	T	O	R	T	M
T	M	E	T	T	U	E	M	U	U	C	T	O	P	E	M	U	U	E	P	U	M	C	M	U	C
M	T	P	O	U	C	E	C	M	T	R	E	M	C	P	C	M	C	T	P	M	M	P	P	C	M
U	U	U	U	C	M	C	C	C	P	T	M	M	U	C	R	E	U	U	C	T	R	R	E	U	C
U	R	E	C	P	M	R	C	E	C	U	C	E	U	C	C	P	M	C	T	T	P	C	R	E	U
R	M	U	T	U	P	M	P	P	M	M	C	U	T	M	C	M	C	C	E	U	U	C	T	U	P
U	U	U	U	U	R	C	U	M	E	P	O	T	U	U	U	C	T	E	P	C	C	P	M	C	C
T	P	C	P	U	M	E	R	U	C	U	M	E	M	M	R	M	U	P	C	M	U	U	C	U	C
R	U	U	U	U	C	P	C	U	P	C	E	C	M	C	U	U	P	O	P	C	U	U	U	U	C
U	T	T	C	P	C	M	C	U	U	C	C	E	P	U	U	P	C	M	P	U	C	M	M	M	P
U	U	U	E	P	M	P	P	E	C	R	C	M	P	R	E	C	R	R	U	M	C	U	E	C	P
U	P	U	C	E	M	P	M	U	C	R	T	U	T	U	C	R	C	C	U	P	U	U	C	U	M
M	P	U	U	U	U	E	C	U	U	C	C	E	C	P	P	P	R	R	M	C	M	M	E	C	C
R	M	M	R	C	C	E	C	T	U	R	M	C	E	C	C	C	P	M	M	M	R	P	E	C	U
U	U	C	P	P	M	M	E	C	C	M	M	R	R	C	M	U	C	M	R	C	P	C	U	C	M
U	C	C	C	P	C	T	R	C	U	U	E	U	C	C	M	T	E	M	C	R	C	P	E	C	C
U	U	C	U	U	C	P	E	T	P	C	C	P	P	T	U	M	P	C	M	P	C	M	C	E	U
C	C	C	P	C	U	C	T	C	C	C	M	T	U	M	P	T	U	M	E	U	C	P	P	M	U
M	P	M	M	R	E	M	C	U	M	M	M	E	R	U	C	U	C	C	M	P	U	U	E	U	C
P	C	E	P	P	R	U	U	C	C	U	C	T	P	U	E	T	E	R	C	M	M	M	U	R	U
U	P	U	R	P	U	E	E	M	U	M	U	M	R	C	U	U	C	R	M	R	C	P	T	E	M
E	C	M	M	U	C	U	C	U	U	P	P	E	T	T	T	M	P	C	P	M	M	U	E	M	P
P	C	U	T	P	M	C	M	U	U	P	U	C	C	P	M	P	R	C	M	C	R	P	U	P	M
E	M	U	U	U	R	C	O	C	P	C	U	E	P	M	R	C	P	T	M	M	M	M	C	C	E
C	U	M	C	U	U	C	E	C	P	P	U	C	P	M	R	M	E	P	C	U	U	R	U	C	U
C	P	R	T	U	E	R	M	C	C	R	P	M	U	U	R	U	U	P	M	E	U	P	C	E	C
P	T	R	U	T	U	M	C	E	C	E	P	C	U	T	C	U	C	P	E	P	C	C	U	U	E
T	P	P	C	P	U	U	M	C	M	M	R	O	U	C	C	P	U	C	P	P	E	P	M	E	C
R	P	C	M	C	U	M	P	U	C	U	U	U	E	M	M	C	U	T	M	C	U	M	C	U	E
U	C	M	U	C	C	T	P	U	R	E	U	P	P	C	O	P	M	P	M	U	U	M	M	M	U
U	E	T	P	U	U	U	U	U	P	P	P	P	M	U	E	C	E	R	U	R	P	U	R	T	P
M	P	P	P	M	E	M	C	T	U	P	C	M	E	C	P	P	C	C	E	M	U	R	M	P	T
U	U	R	C	U	E	P	C	U	E	C	P	U	T	C	U	R	U	C	P	R	U	M	T	C	O
C	C	M	P	U	C	M	E	P	E	M	P	R	U	P	P	E	C	C	P	C	U	U	C	C	C
E	U	M	R	U	U	E	U	U	E	U	C	P	C	P	M	P	U	C	U	M	P	U	C	U	M
P	P	R	E	U	U	U	P	E	U	P	E	U	U	C	T	P	O	T	U	P	E	T	U	O	E
C	O	T	T	E	M	O	T	E	U	T	E	U	M	U	P	M	U	T	P	O	U	P	E	T	E
R	P	U	T	P	R	U	U	U	P	O	T	T	E	P	T	R	R	M	T	C	E	T	O	R	O
P	M	T	R	E	T	R	C	O	E	T	P	R	O	E	E	P	T	E	P	M	M	E	U	P	E
P	E	P	U	P	U	U	R	E	E	P	E	R	T	P	E	E	C	E	P	O	R	T	U	E	M
E	T	T	E	P	T	E	R	M	M	T	T	E	T	T	T	P	O	R	U	M	P	T	T	E	R
P	P	U	U	R	M	T	T	O	M	T	M	U	M	M	U	U	T	U	O	E	P	E	U	U	O
T	C	P	E	P	T	M	R	E	R	U	R	P	E	T	P	P	T	T	P	C	O	R	P	T	T
T	M	U	T	R	U	P	P	T	E	R	R	E	U	R	P	R	T	R	E	T	T	R	C	P	R
C	U	U	M	U	P	R	U	U	U	M	T	P	R	T	R	E	T	T	U	U	U	O	C	U	M
U	U	U	U	M	O	T	T	P	E	M	E	T	T	E	R	P	C	T	O	E	T	U	U	R	M
E	P	E	E	O	R	C	P	E	T	M	P	P	R	U	T	T	R	U	U	E	T	M	O	T	M
U	U	M	T	E	R	U	T	O	T	C	R	P	M	U	R	M	U	M	R	M	P	M	O	O	M
O	U	O	T	P	O	R	E	M	E	M	U	P	T	O	R	T	R	R	P	O	O	U	T	P	P
P	E	P	M	T	P	E	O	C	T	R	R	M	E	T	O	R	T	P	E	M	M	P	E	E	E
T	R	U	U	R	U	R	P	P	U	P	U	R	T	R	O	U	M	T	M	R	C	U	O	T	E
T	R	C	R	P	E	E	C	P	T	E	E	U	U	E	M	T	T	P	U	R	U	P	E	U	O
E	U	U	M	P	E	M	U	U	T	T	E	R	E	U	M	E	R	T	T	E	T	T	T	M	E
U	T	M	R	T	O	R	M	E	C	U	C	U	E	U	E	P	R	U	M	T	U	U	E	R	M
U	T	R	E	U	U	P	E	E	M	E	E	R	C	U	U	U	T	R	M	R	T	R	M	U	U
M	M	E	P	P	T	P	R	T	E	M	T	E	M	P	E	U	E	T	P	O	O	O	U	U	M
O	T	O	U	T	O	O	P	E	P	R	U	U	R	T	T	T	M	U	R	T	U	T	E	T	P
C	O	T	E	M	T	U	O	E	T	R	M	T	E	T	E	M	M	T	U	M	O	E	E	O	O
U	M	O	P	T	P	R	U	T	M	R	M	T	R	T	P	T	U	U	E	P	U	U	P	U	R
R	O	E	U	E	R	U	U	O	U	P	R	T	M	E	T	P	E	P	P	O	T	R	M	C	M
R	U	T	T	P	U	U	E	U	R	T	T	E	E	T	E	T	U	U	E	U	E	E	T	U	R
R	M	E	E	M	R	E	U	R	C	T	P	E	M	U	U	R	E	P	R	U	E	O	R	U	R
U	U	P	T	U	M	P	E	M	T	T	P	T	U	E	M	U	P	M	O	R	T	O	O	O	U
T	P	P	M	U	U	P	U	P	E	R	E	R	U	U	O	U	E	E	T	U	P	E	T	E	T
P	T	T	T	E	M	R	U	U	R	T	T	T	U	T	T	M	U	P	R	P	R	R	U	R	U
U	T	M	T	U	R	T	C	U	E	E	O	M	R	R	T	E	T	T	M	U	T	P	P	R	P
E	P	T	R	E	E	O	O	T	T	E	T	R	E	T	R	U	T	P	R	U	T	M	U	U	U
T	M	U	U	C	T	U	U	P	U	E	R	U	E	E	M	M	U	E	E	T	T	P	E	T	M
U	M	E	T	T	E	T	T	P	M	R	E	M	R	T	P	T	E	T	O	U	R	T	P	P	O
E	T	T	O	M	T	P	T	E	T	E	U	T	P	U	C	U	M	U	C	U	O	E	T	U	C
P	E	C	U	C	M	U	P	M	U	C	U	T	T	U	C	T	U	U	M	U	C	U	R	P	U
C	P	M	C	U	U	M	U	C	C	E	P	C	M	M	U	C	P	T	P	U	M	U	P	U	C
M	E	C	M	P	U	M	P	P	M	U	E	M	P	P	E	P	U	T	E	U	M	E	P	E	P
U	P	U	U	R	M	T	P	E	M	R	P	M	M	P	T	P	O	P	R	C	R	U	E	P	C
M	P	P	M	R	C	C	C	P	U	C	U	P	T	U	M	U	U	P	C	P	E	M	P	T	U
U	M	C	C	C	U	P	C	C	U	T	U	U	U	R	C	E	M	P	E	U	C	M	R	P	P
E	P	C	C	M	M	M	U	M	P	E	C	M	T	R	E	R	P	U	M	P	C	C	P	T	U
C	M	C	O	P	C	U	R	U	E	C	M	T	E	C	M	M	C	C	R	P	P	E	P	U	U
C	U	T	M	U	U	U	C	C	T	M	C	M	E	C	P	C	U	U	U	P	U	C	U	U	U
T	C	U	C	C	P	T	U	U	C	C	M	M	P	P	R	E	M	C	U	U	R	U	U	M	U
E	U	U	P	P	U	C	R	P	M	R	U	P	C	M	U	U	E	C	U	U	C	C	U	U	R
C	E	R	R	C	U	C	P	M	P	U	U	M	T	U	U	R	C	M	P	E	M	U	U	U	U
C	T	U	M	T	T	T	C	U	M	P	U	M	C	M	R	T	U	U	U	C	P	P	M	E	P
U	C	T	O	U	P	C	M	M	C	E	C	U	M	C	P	E	C	U	P	M	T	E	P	R	U
U	R	U	R	M	P	U	P	E	R	C	R	U	U	C	C	C	M	P	C	U	C	M	R	M	P
M	P	E	E	P	T	P	E	M	C	U	R	C	P	C	P	U	R	U	T	E	U	U	E	U	U
U	P	T	C	U	C	C	C	E	M	M	T	U	T	R	E	R	E	M	P	R	R	M	U	C	C
R	C	U	M	U	E	P	U	P	U	E	U	E	P	M	U	T	R	U	C	C	M	U	U	C	M
M	U	U	P	M	E	C	M	M	E	M	U	U	U	C	M	R	P	C	M	C	U	U	C	C	E
T	P	C	P	R	R	M	U	R	R	C	T	E	C	M	C	M	U	U	U	U	U	U	E	C	U
U	C	U	U	T	E	P	M	U	U	R	C	C	C	U	U	R	C	U	C	E	C	P	P	U	C
M	U	R	C	U	U	C	R	U	C	M	C	R	C	C	C	U	C	U	M	E	M	U	U	C	P
P	P	P	R	C	R	U	R	U	C	M	C	P	P	C	R	M	P	U	E	P	U	M	P	O	M
U	M	M	C	U	U	U	P	C	C	C	E	C	T	M	R	P	U	P	M	P	O	C	C	T	P
C	M	U	U	M	C	M	C	C	T	U	C	E	C	U	U	M	C	C	M	C	U	E	R	T	T
R	C	M	M	U	M	T	C	P	E	R	U	U	M	M	T	R	U	E	U	M	C	M	C	C	M
C	U	U	P	M	U	C	C	T	P	U	M	C	U	T	P	U	M	C	U	U	U	U	C	P	P
U	C	E	T	U	P	E	R	T	R	U	U	U	U	M	M	C	U	M	E	E	M	C	T	C	C
P	U	R	R	U	U	R	C	P	C	U	P	C	C	U	P	M	P	M	M	U	R	U	U	C	C
C	E	P	R	P	U	M	M	U	T	C	M	C	M	C	C	C	U	C	P	P	C	M	E	P	C
R	E	M	U	U	R	C	T	P	E	M	C	M	C	C	P	R	U	C	C	U	U	U	C	C	U
U	P	C	U	U	P	U	T	R	U	E	E	U	U	U	E	U	C	R	P	M	R	U	U	U	O
C	P	O	C	R	P	C	M	E	C	R	C	P	C	E	C	U	U	E	C	P	P	U	M	P	P
E	P	C	P	R	M	P	E	U	C	P	T	U	E	M	T	U	T	T	E	O	P	R	U	E	P
E	P	M	T	P	U	P	T	T	R	R	E	R	P	U	E	M	M	O	P	M	U	P	R	U	U
U	M	E	M	P	P	P	U	T	O	U	R	O	P	R	O	P	P	M	E	T	P	R	M	T	U
U	R	P	T	P	U	U	T	O	U	U	M	T	E	P	C	O	E	M	C	U	U	T	P	U	U
P	T	O	T	U	U	T	T	U	U	U	R	T	P	T	R	T	T	M	O	C	T	R	U	T	R
O	T	T	R	O	P	T	U	M	P	P	M	U	R	T	E	U	M	T	P	E	U	M	C	M	P
R	E	P	M	R	E	E	E	E	U	T	T	T	E	U	U	T	M	T	P	U	R	U	E	U	U
M	T	U	P	P	U	T	T	R	E	M	T	P	T	R	R	U	T	U	R	T	R	U	U	T	O
T	E	R	O	T	M	U	U	U	T	M	U	P	T	P	U	U	R	T	E	R	U	M	M	T	M
T	T	U	P	R	P	P	P	E	M	E	P	C	M	U	M	T	R	R	E	M	U	C	E	U	P
P	T	T	T	T	T	P	R	U	U	U	R	T	E	E	P	U	P	U	T	M	M	T	U	P	M
R	U	O	P	E	U	E	E	T	M	M	P	E	M	T	P	E	C	R	E	T	M	E	O	U	T
M	E	E	P	R	E	U	M	E	M	R	T	O	T	E	M	T	O	T	P	T	E	C	E	P	T
U	T	R	E	E	E	M	P	P	T	P	E	E	C	P	P	T	M	U	U	T	M	U	M	P	R
M	E	R	E	U	U	P	T	O	E	O	P	U	E	P	T	R	T	T	E	P	M	O	U	M	P
E	U	T	M	T	T	M	U	U	U	T	T	P	T	E	R	M	T	R	R	U	U	R	U	U	E
U	R	T	E	E	M	U	T	T	E	P	O	U	U	E	M	E	E	P	C	R	U	R	M	E	T
M	E	T	O	R	E	U	U	O	T	R	T	P	R	T	T	E	U	M	M	T	P	M	M	R	P
E	U	U	R	E	R	T	E	O	T	U	T	R	R	O	T	O	T	E	T	T	E	O	T	U	E
U	U	E	T	U	E	T	P	M	U	O	O	R	T	O	U	M	C	O	T	U	E	C	E	U	U
R	E	U	U	M	T	T	E	R	U	O	T	T	M	T	E	T	T	E	O	T	U	T	E	P	T
R	C	T	U	U	P	P	E	R	U	T	O	U	U	E	O	R	M	U	E	M	P	R	E	M	U
U	P	O	P	M	O	U	O	O	T	E	C	U	O	E	T	U	C	M	T	T	P	T	T	U	U
R	T	T	M	M	O	P	T	P	U	C	M	T	U	U	O	M	U	M	T	T	T	O	R	T	U
P	E	T	E	T	R	O	M	T	R	E	T	T	U	E	U	U	T	P	P	T	M	E	U	M	U
R	U	U	U	U	R	E	T	U	T	R	U	R	R	T	T	P	P	T	T	P	O	E	T	E	M
U	O	T	C	O	U	E	M	T	T	M	T	U	E	U	U	P	T	U	P	U	P	T	R	O	T
U	E	E	R	O	E	R	O	U	E	M	C	P	T	E	R	C	P	P	T	M	U	U	M	T	O
M	C	E	M	U	T	P	T	T	T	O	U	T	O	E	M	T	T	P	P	C	R	E	P	O	T
E	P	P	E	R	P	O	P	P	O	T	E	U	U	U	U	R	P	U	U	C	P	R	P	R	M
T	R	E	U	U	E	R	M	U	C	T	O	P	T	T	U	U	T	P	M	C	T	R	M	E	T
E	M	M	U	O	P	T	U	U	E	T	P	P	M	M	R	M	T	U	P	R	M	U	P	R	M
O	U	P	R	T	E	U	U	U	R	M	M	C	O	R	T	U	M	T	O	E	T	M	U	P	M
U	T	T	P	U	T	T	E	R	M	U	U	P	C	E	T	M	T	U	P	T	P	P	E	T	R
U	T	T	P	O	T	M	E	C	U	R	C	P	U	O	P	M	T	P	M	C	M	P	E	P	C
M	M	U	O	R	R	M	P	C	M	M	O	R	C	C	U	T	C	C	O	M	C	U	U	P	R
C	P	P	P	U	C	U	U	E	U	P	R	U	P	M	C	E	C	T	M	C	C	U	U	R	P
P	M	U	U	E	U	U	U	U	C	E	T	U	U	R	C	P	U	U	R	E	U	C	E	C	U
C	C	U	E	C	U	U	U	R	C	P	P	M	C	C	C	U	P	R	M	U	C	M	U	C	P
R	U	P	P	U	O	M	P	U	U	U	C	M	U	U	C	P	M	U	C	R	C	P	M	M	T
C	M	M	U	O	M	C	M	C	C	M	U	U	P	C	C	T	U	R	U	E	U	U	U	C	U
M	T	U	C	C	M	M	U	C	T	C	R	R	U	R	U	M	R	P	R	U	C	U	C	E	M
U	C	C	U	U	U	E	T	U	M	C	P	C	U	R	P	U	R	C	U	U	M	U	P	P	C
E	M	P	P	P	U	U	M	P	P	C	C	P	R	R	C	E	C	C	R	M	C	P	P	R	C
C	R	P	P	M	U	U	U	R	C	M	E	P	C	P	U	C	C	C	C	U	P	R	R	U	U
P	M	C	E	M	C	U	T	M	U	C	C	M	E	P	M	M	P	P	M	U	U	C	C	E	M
P	R	E	U	U	T	C	P	C	U	C	M	C	C	U	C	M	R	T	P	M	P	C	U	C	P
P	M	R	C	M	P	C	P	E	M	P	P	P	M	R	U	U	C	C	U	U	P	R	C	E	R
T	U	U	P	C	U	M	U	P	U	M	P	C	R	C	C	E	P	C	U	C	C	P	M	T	R
P	C	P	C	U	U	C	R	P	P	R	U	R	C	C	M	E	U	U	R	U	U	M	U	R	P
E	M	R	U	C	C	M	M	U	C	R	M	C	T	M	R	P	R	C	U	C	M	C	U	U	C
U	M	M	U	U	U	E	M	C	T	M	C	C	M	U	C	T	C	M	U	C	M	P	M	U	T
R	U	R	R	E	O	C	U	C	R	C	U	P	U	C	M	P	C	E	U	C	C	E	U	U	E
P	U	M	P	T	C	C	E	U	R	C	U	U	C	P	U	R	C	T	P	E	U	U	M	M	U
U	U	C	C	M	M	T	U	C	R	C	R	M	R	P	O	U	C	U	C	U	P	C	M	P	C
U	C	T	P	M	M	U	P	U	C	U	M	U	M	C	U	T	P	P	M	E	U	U	U	P	U
P	C	U	U	U	U	C	M	P	U	E	M	C	U	P	C	C	R	P	P	R	U	U	M	C	C
U	C	U	P	C	P	C	P	C	C	U	U	U	C	U	R	C	C	P	U	R	C	U	T	U	R
E	C	R	U	U	C	M	T	C	C	C	M	U	C	C	P	P	P	C	M	U	C	C	U	U	U
U	U	M	M	P	U	C	R	C	U	E	C	C	T	P	C	P	M	E	E	C	M	U	U	C	C
C	U	U	M	C	P	C	C	C	U	U	C	U	P	C	U	P	U	T	C	M	M	C	U	M	M
M	U	M	M	P	U	M	M	P	T	R	M	M	P	P	P	M	R	U	U	U	C	U	U	R	E
T	U	C	P	E	C	R	P	U	R	U	R	C	C	C	T	P	P	M	T	P	U	P	M	P	P
M	R	M	U	R	P	U	P	U	U	U	U	U	E	P	U	C	M	P	R	P	P	C	C	R	O
U	U	E	C	T	U	P	C	U	P	C	C	U	U	C	P	C	P	C	M	U	E	C	M	U	T
U	U	P	C	U	U	T	P	P	P	C	M	M	U	P	C	C	R	U	C	E	R	T	U	C	T
E	C	M	C	U	U	E	C	R	P	U	M	C	U	T	C	U	E	C	C	U	P	C	U	C	C
P	U	R	P	M	M	T	U	T	P	P	O	C	U	R	C	P	C	P	P	M	C	M	C	C	C
P	U	P	P	M	R	U	T	E	R	M	O	T	U	M	U	U	E	M	R	C	U	U	T	P	U
P	P	T	T	T	M	U	O	T	T	E	R	P	R	E	T	T	R	M	T	E	M	T	E	U	U
T	T	R	P	T	T	C	U	T	M	T	U	P	M	R	E	U	P	M	U	E	U	U	U	U	U
P	T	E	T	C	P	U	C	E	E	C	T	E	R	M	M	T	M	O	T	M	P	M	E	T	R
P	E	R	O	P	E	M	E	M	M	P	R	P	T	R	U	P	T	U	O	E	U	M	P	P	U
R	M	U	U	E	M	M	M	P	U	C	P	U	M	U	T	M	P	E	U	U	O	P	P	U	O
M	P	T	O	T	R	R	M	T	P	C	P	P	P	R	E	P	E	E	R	M	R	E	M	U	T
P	O	U	E	M	P	P	E	E	R	R	M	T	R	T	O	M	E	P	T	E	M	U	E	P	R
T	U	R	O	O	T	O	M	U	P	P	E	R	O	T	T	P	T	T	M	P	P	T	P	C	U
U	U	M	T	T	U	R	E	O	P	M	T	R	E	T	T	M	E	E	U	U	O	P	M	E	R
M	P	E	T	E	E	R	M	U	T	T	M	M	P	E	P	O	E	T	M	E	T	E	R	U	U
O	O	R	M	E	M	M	T	R	U	U	R	U	O	P	R	U	P	R	P	P	U	U	U	E	E
E	T	T	T	T	P	E	U	R	E	R	R	P	U	E	T	R	U	U	E	O	O	O	U	E	T
E	U	U	M	U	T	U	R	U	T	R	U	U	T	O	P	O	T	U	P	M	U	R	U	U	E
R	U	U	U	P	U	O	O	T	T	T	P	M	E	U	E	R	T	M	O	U	M	T	P	P	P
E	O	M	T	T	U	U	U	O	E	U	U	E	T	U	U	E	T	U	R	P	U	M	T	M	M
E	R	R	U	U	E	T	O	T	P	T	T	T	R	P	T	M	P	E	E	M	T	M	E	U	U
P	O	E	T	T	P	P	P	R	U	T	E	E	C	O	U	M	E	U	U	T	T	R	T	T	T
R	T	T	R	T	T	M	E	P	P	T	R	T	P	O	U	T	R	T	T	O	P	E	C	R	T
P	U	T	T	C	E	M	P	T	O	M	R	E	T	T	T	R	E	U	C	O	T	O	T	R	P
R	U	R	P	T	U	T	E	U	U	E	P	M	E	O	T	M	M	U	U	U	R	R	E	T	M
O	U	M	M	P	C	P	E	T	P	T	P	R	M	T	U	P	U	E	T	E	T	E	E	M	C
C	T	E	R	U	R	O	E	E	P	R	R	R	R	T	P	T	U	U	M	T	P	E	E	M	C
U	O	U	U	R	E	C	T	U	P	P	R	T	P	P	M	T	M	U	M	C	T	T	T	P	R
R	E	O	U	T	P	E	R	U	T	M	P	U	R	R	U	T	U	M	O	T	T	E	E	T	M
T	R	M	R	T	O	M	T	R	R	R	T	O	P	T	T	E	R	U	O	O	M	U	T	P	R
M	M	P	R	P	U	E	T	M	E	U	T	T	M	P	P	R	T	P	T	P	T	T	U	U	M
R	T	E	T	T	R	R	O	T	U	R	U	T	R	U	U	C	M	R	C	M	T	O	C	R	U
T	P	O	T	T	P	T	M	T	E	O	R	R	M	R	U	E	U	R	R	T	T	O	U	R	U
P	T	U	E	C	T	E	O	T	M	T	P	R	T	P	U	M	M	R	E	E	E	P	O	R	P
U	R	P	R	U	M	E	M	O	T	T	R	O	P	R	U	E	T	T	U	E	T	R	O	M	T
O	U	E	O	P	U	T	M	T	U	R	P	T	P	R	R	T	M	O	R	E	T	C	T	M	T
M	U	E	T	T	M	R	T	T	E	O	R	P	C	P	P	M	M	U	M	T	T	O	U	M	T
E	U	U	R	T	R	T	R	M	E	M	U	U	T	M	T	U	T	R	E	T	P	M	T	P	P
M	M